############################################################
#..........................................................#
#..........................................................#
#.....@....................................................#
#..........................................................#
#..................................................   (  !.#
#..................................................       .#
#..................................................$      .#
#......................................    ~   ....       .#
#......................................(   $   .... $     .#
#......................................        ............#
#......................................        ............#
#......................................    $ g ............#
#.............................!           ~(b !  ..........#
#.............................   $     r !       ..........#
#.............................                  (..........#
#.............................$  $               ..........#
#................................>.........................#
#..........................................................#
############################################################
