############################################################
#..........................................................#
#..........................................................#
#..........................................................#
#..........................................................#
#..........................................................#
#..........................................................#
#..........................................................#
#..........................................................#
#........                             >      $ ............#
#.....          (               b              ............#
#.....           ^         $                   ............#
#.....             g                           ............#
#.....   ^          !                    g     ............#
#.....                                  g $    ............#
#.....       ^           ^                     ............#
#.....                            .........................#
#.................                .........................#
#.......................................@..................#
############################################################
