############################################################
#..........................................................#
#..........................................................#
#..........................................................#
#..........................................................#
#..........................................................#
#..........................................................#
#..........................................................#
#................>.........................................#
#..........................................................#
#.........................         (!(      ...............#
#.........................                              ...#
#.........................   r !     !    $             ...#
#.........................~     (                       ...#
#...........................   ^                        ...#
#...........................         (        (    !$   ...#
#.................@.........                  ~  g      ...#
#...........................                   (    g   ...#
#............................................   !  ^    ...#
############################################################
