############################################################
#..........................................................#
#................................................        ..#
#................................................        ..#
#................................................        ..#
#................................................        ..#
#................................................        ..#
#......................        (    .............        ..#
#......................             .............        ..#
#......................             .............       r..#
#..........                     >   .............        ..#
#......                                  ..              ..#
#......                                  ..              ..#
#......   !     b              g         ..              ..#
#@.....        $  (       (^             ..     (   ^    ..#
#......                          (       ..              ..#
#......                                  ..      ..........#
#......        (     g            ~      ..................#
#..........................................................#
############################################################
