############################################################
#..........................................................#
#..........................................................#
#............................      $                     ..#
#...            (          $    (                         .#
#...                                        !             .#
#...                             b                        .#
#... ~           (                                        .#
#...                   (          ^                       .#
#...                                                      .#
#...                              b                       .#
#...      ~                       (    @      !         ($.#
#... >               ^                                    .#
#...    (                                                 .#
#...........................            g      $         ..#
#...........................                             ..#
#...........................                             ..#
#...........................                    ...........#
#..........................................................#
############################################################
