############################################################
#..........................................................#
#..........................................................#
#..............                ~                    .......#
#..............        !                            .......#
#..............                                     .......#
#............(                              !       .......#
#............                        b              .......#
#............      $                            b   .......#
#............             (          ^    $@        .......#
#............                                       .......#
#............      (              $   !g            .......#
#............                       ^               .......#
#............    b            $                     .......#
#.......>....          $ (                          .......#
#............  ^                 ~                  .......#
#............     $                ^     !          .......#
#..........................................................#
#..........................................................#
############################################################
