############################################################
#...........................@..............................#
#...........         ......................................#
#...........         ......................................#
#...........         ......................................#
#...........(        ............................        !.#
#.......... $       !                        ....         .#
#..........            !           (         ....         .#
#..........       g                          ....     g   .#
#..........                       ^          ....         .#
#..........              $             (     ....    !    .#
#..........                                  ....    (    .#
#..........                  >                            .#
#..........      !  ^                                   ( .#
#..........                        $              (       .#
#..........                                               .#
#.................                        .......      g  .#
#..........................................................#
#..........................................................#
############################################################
