############################################################
#..........................................................#
#..........................................................#
#........................................          ........#
#........................................          ........#
#........................................          ........#
#..........................>............!                  #
#.......................................         !         #
#.......................................   ~          (    #
#................                                (         #
#................(             $ (    ~  !                 #
#................               $ ~                    ....#
#................                 $b                   ....#
#................                 (   b                ....#
#................                                 ~    ....#
#................          ~            (       !      ....#
#................                   b                  ....#
#..............................         .........      ....#
#...................@..........         ...................#
############################################################
