############################################################
#.......................>..................................#
#..........................................................#
#..........................................................#
#.....................                              .......#
#.....................        (        ~            .......#
#.....................     !                        .......#
#.....................                      $       .......#
#.....................  (    $^g            !   (   .......#
#.....................(          b   $              .......#
#.........................              (        r.........#
#..                                    (   !           ....#
#..                                          (~        ....#
#..                        $                  $      ^   ..#
#..                           r                          ..#
#......................................                  ..#
#............@.........................                  ..#
#..........................................................#
#..........................................................#
############################################################
