############################################################
#..........................................................#
#..........................................................#
#..........................................................#
#..........................................................#
#..........................................................#
#.....................>............       ~            ....#
#..@...............................         (          ....#
#..................................                   ~....#
#..................................         r   ^      ....#
#..................................                    ....#
#..................................                    ....#
#...........................           (               !...#
#...........................         !                  ...#
#...........................                  ^         ...#
#...........................(                         ^ ...#
#...........................                            ...#
#...........................      r                     ...#
#...........................  b                         ...#
############################################################
