############################################################
#..........................................................#
#..........................................................#
#........................................   !             .#
#...........................                              .#
#...........................                        ^     .#
#...........................        $  (      b           .#
#...........................                              .#
#...........               $                     (        .#
#...........   !@                b          ^ (           .#
#...........                      !    ^        !   .......#
#...........             ^                  (    $$ .......#
#...........                   >         $ g        .......#
#........................................         .........#
#........................................         .........#
#........................................         .........#
#........................................   ~     .........#
#........................................         .........#
#..........................................................#
############################################################
