############################################################
#.............................>............................#
#..........................................................#
#..........................................................#
#.......                                         ..........#
#.......                          !              ..........#
#.......           @               $             ..........#
#.......                                          .........#
#.......                        $ r               .........#
#.......                                      r   .........#
#.......                       !          b       .........#
#.......               (  (            (   (      .........#
#.......        ^~  ! (                           .........#
#.......                   !               $  .............#
#.......                     ^                .............#
#.......             !                  !     .............#
#.......                       !              .............#
#..........................................................#
#..........................................................#
############################################################
