############################################################
#..........................................................#
#...   b  g                                   ...>.........#
#...                                          .............#
#...              (                           .............#
#... (        !                     $         .............#
#...                                                    ...#
#...               (                                    ...#
#...                                     !              ...#
#...             (                 b                    ...#
#...                                   (             ......#
#.................           !  ^ .....  ^   !       ......#
#.................                .....              ......#
#.................     $       @  .....      (       ......#
#.................                .....              ......#
#.................                .........................#
#.................                .........................#
#..........................................................#
#..........................................................#
############################################################
