############################################################
#..........................................................#
#..........................................................#
#..........................................................#
#..............................................>...........#
#.                                                b       .#
#.                    ^            $                      .#
#.                                  ~                     .#
#.                                  (                     .#
#.           r                                            .#
#.                               !                        .#
#.               (      !                       $          #
#.                 $                                    ~  #
#.           !                      (           (  (       #
#.           ^                            $                #
#.........                        $        @               #
#.........                              (                  #
#.........                                                 #
#.........           b             !                       #
############################################################
