############################################################
#..........................................................#
#..........................................................#
#..........................................................#
#..........................................................#
#..........................................................#
#..........................................................#
#...........................                ...............#
#...........................        g     !~              .#
#...........................         !                   (.#
#...........................(                     $$      .#
#.......................@...            >                 .#
#...........................     ~         ^ ~            .#
#...........................         b      ...............#
#...........................   ~        ^   ...............#
#...........................(               ...............#
#..........................................................#
#..........................................................#
#..........................................................#
############################################################
