############################################################
#..........................................................#
#........................                    (     ........#
#........................                          ........#
#........................          !  ~            ........#
#........................                          ........#
#..........@...............................................#
#..........................................................#
#..........................................................#
#..........................................................#
#..........................................................#
#..........................................................#
#...............                  !   ...             $ ...#
#...............                      ...g r            ...#
#...............                      ...               ...#
#...............   $    ^             ... >       (     ...#
#...............                 $    ...              $...#
#...............         !            ...               ...#
#...............      $       g ~     .....................#
############################################################
