############################################################
#..........................................................#
#..........................................................#
#.............................                         ....#
#........     !                                        ....#
#........      $             r      ~                  ....#
#........               ^        !                     ....#
#........                                  (           ....#
#........                 r                      !     ....#
#........                                              ....#
#........            ^   !                             ....#
#........                     (            b               #
#........               @                               $  #
#........          $         $                             #
#........   b                         $!       $  ( (      #
#..........                                              > #
#..........                                                #
#..........                                                #
#..........................................................#
############################################################
