############################################################
#..........................................................#
#..........................................................#
#..........................................................#
#..........................................................#
#..........................................................#
#................................                (         #
#................................                          #
#......>.........................                          #
#................................        r         !       #
#..........................................................#
#......................      $                    .........#
#...                              (!  r           .........#
#...   (                (  (                      .........#
#...         ^~                                   .........#
#...                   (                     (    .........#
#@..         r                   ~                .........#
#...             (    b      !~                   .........#
#...     $(                                     ^ .........#
############################################################
