############################################################
#..........................................................#
#....................................................$     #
#.....................................       ........      #
#..................................... (     ........      #
#.....................................       ..            #
#..@....................>.............       ..            #
#.....................................       ..            #
#..............................................        r   #
#..........................................    $           #
#..........................................                #
#..........................................                #
#..........................................                #
#........                               $        $         #
#........                                      ^   g       #
#........             ~                                  ..#
#........                                  ~             ..#
#........        ~        g                              ..#
#..........................................      ^   ......#
############################################################
