
............................................................
............................................................
...#######################################################..
...#                                              #      #..
...#  @                                           #      #..
...#      !                                       #      #..
...#                ^                             #      #..
...#                          g                   #      #..
...#                                         $    #      #..
...#                     ~                        #      #..
...#           ^                                  +  b   #..
...#                                    r         #    > #..
...#                               ~              #      #..
...#                                              #      #..
...#                (                             #      #..
...#                                              #      #..
...#                                              #      #..
...#                                              #      #..
...#######################################################..
............................................................
