############################################################
#..........................................................#
#..........................................................#
#.................................................>........#
#..........................................................#
#..........................................................#
#......                                    ................#
#......                                    ................#
#......                                    ................#
#......               b     g                              #
#......               r      $    ^         @              #
#......              ~              (  ~             !     #
#......             $                                      #
#......          (         ^                        !      #
#..........................                                #
#..........................                                #
#..........................              !                 #
#..........................................................#
#..........................................................#
############################################################
