############################################################
#......................>...................................#
#..........................................................#
#..........................................................#
#..........................................................#
#..........................................................#
#..........................................................#
#.....           ..........................................#
#.....           ....            ..........................#
#.....           ....      b     ..........................#
#.....(    (     ....            ..........        g       #
#.....           ....            ..........                #
#.....           ....            ..........   ~  r       ! #
#.....           ....!           ..........   !            #
#..........................................              ~ #
#..........................................                #
#..........................................................#
#.........................................@................#
#..........................................................#
############################################################
