############################################################
#..........................................................#
#..........................................................#
#........>                                 ................#
#........                   !              ................#
#........                                  ................#
#........                          g                    ...#
#........                                               ...#
#........                           (                   ...#
#........                            g                  ...#
#........                                               ...#
#.                           b g                      $ ...#
#.              ~                    !                  ...#
#.                                         ..............@.#
#.                             ~           ................#
#. (                                       ................#
#.             !      ^                    ................#
#.                 !                      .................#
#.                                        .................#
############################################################
