############################################################
#..........................................................#
#..........................................................#
#...............                           ................#
#...............~                          ................#
#...............                           ................#
#...............          >   !            ................#
#...............          !                ................#
#...............                           ................#
#...............       ~                   ................#
#...............                        !  ................#
#...............                  g     b^ b            ...#
#...............             (  b !^            $^      ...#
#........@....................             b            ...#
#.............................                          ...#
#.............................                       ^  ...#
#...........................................            ...#
#..........................................................#
#..........................................................#
############################################################
