############################################################
#..................................@.......................#
#..........................................................#
#..........................................................#
#...............                            ...............#
#...............                            ...............#
#...............                     r      ...............#
#...............          ~                 ...............#
#.                  >                       ...............#
#.                                                       ..#
#.    ^                       g                 r        ..#
#.                                                       ..#
#.                   !              ^!                   ..#
#.            g      !         ^  $         ....         ..#
#.                                          ....         ..#
#.                                    ..........         ..#
#.                                    ..........         ..#
#. !                                  ..........         ..#
#..........................................................#
############################################################
