############################################################
#..........................................................#
#..........................................................#
#..........................................................#
#..........................................................#
#.......                                               ! ^.#
#.......                         (                        .#
#.......    $                       $                     .#
#.......                          !                       .#
#.......                                                  .#
#....               (                                     .#
#....    !                !                               .#
#....              r    g                                 .#
#....                                       b             .#
#....                                              !      .#
#....                    $                                .#
#....                                                     .#
#....           .............@.............................#
#....  ~       ^........>..................................#
############################################################
