############################################################
#####  $                                                  ##
####                      $        (    r                  #
### g    !                                                 #
##        $                    @                           #
###                     !           $                      #
####         $                                             #
#####                                         ~     $      #
######                           $                       ###
#######             !                   r               ####
########                                               #####
#########                                           ! ######
##########                  ~         !              #######
###########                                         ########
############                        $              #########
############+    !        ^                       ##########
##############                    $              ###########
###############   >            b                ############
################                      $    ~   #############
############################################################
