############################################################
#..........................................................#
#..........................................................#
#........            $                              b  ....#
#........                                              ....#
#........                    (         ^               ....#
#........        @                                     ....#
#........    b    ~                                        #
#........               (    ~     b   !   (      (        #
#.......................        ....                       #
#.......................        ....         $             #
#.......................   >    ....                       #
#.......................        ....                   (   #
#.......................        ....                 ^     #
#.......................        ...............     $     .#
#.......................        ...............           .#
#..............................................           .#
#..............................................           .#
#..........................................................#
############################################################
