############################################################
#..........................................................#
#..............                                          ..#
#..............                                          ..#
#..............  ^                                       ..#
#..............         ~                   !            ..#
#..............                                          ..#
#.     g.......                              ^           ..#
#.      .......                                          ..#
#.      .......                                          ..#
#.      .......                               ^          ..#
#.      .......                        (                 ..#
#.      .......                              ~           ..#
#.      .......!                                        r..#
#.      .......                          !       $  r    ..#
#.   ^  .......                                          ..#
#........@..........>......................................#
#..........................................................#
#..........................................................#
############################################################
