############################################################
#..........................................................#
#..........................................................#
#..........................................................#
#..........................................................#
#..........................................................#
#...................................@......................#
#...............>..........................................#
#..........................................................#
#..........................................................#
#..........................................................#
#.....................       $     $   ....................#
#.....................        !       (....................#
#...........       !       !   ^       ....................#
#...........$   (  ~    r r    $       ....................#
#...........    (                      ....................#
#...........            $~!   b        ....................#
#...........   b       b               ....................#
#..........................................................#
############################################################
