############################################################
#..........................................................#
#..........................................................#
#..........................................................#
#..........................................................#
#......................                      ..............#
#......................    $                 ..............#
#.............      !              $               !   ....#
#.............        b   ^!                  (        ....#
#.............                                         ....#
#.............                                     @   ....#
#.............               r          !              ....#
#.............         ^                               ....#
#.............                                         ....#
#.............     g                                   ....#
#.............                        $   $  ^(      ( ....#
#.............                               !         ....#
#.............                                  ...........#
#................>.....................         ...........#
############################################################
