############################################################
#..........................................................#
#..........................................................#
#.........................................@................#
#..........................................................#
#................................................~   r ( ( #
#................................................  !   $   #
#................................................       ^  #
#................................................  (       #
#................................................ ^  b   !$#
#................................................  g  r   >#
#................................................   (  $   #
#................................................  (     ! #
#................................................!     $   #
#..........................................................#
#..........................................................#
#..........................................................#
#..........................................................#
#..........................................................#
############################################################
