############################################################
#..........................................................#
#..........................................................#
#..........................................................#
#..........................................................#
#..........................................................#
#..........................................................#
#................................................      ....#
#................................................$(    ....#
#................................................      ....#
#................................................      ....#
#................................................ $ !~ ....#
#...          r          $~$ ....................   ^  ....#
#...                         ..............................#
#...         g     >  @      ..............................#
#... (  !^ !                !..............................#
#... (       (               ..............................#
#...      ~               ^  ..............................#
#..........................................................#
############################################################
