############################################################
#..........................................................#
#..........................................................#
#..........................................................#
#..........................................................#
#..........................................................#
#..........................................................#
#..........>...............................................#
#..........................................................#
#..........................................................#
#.................@........................................#
#..........................................................#
#.........      !    !               ....   $  !^   !   ...#
#.........                  (  $     ....        g      ...#
#.........   !  !$   g  ^            ....               ...#
#.........    $                 r    ....!      $       ...#
#.........  ^                    b   ......................#
#..........      ..........................................#
#..........      ..........................................#
############################################################
