############################################################
#..........................................................#
#..........................................................#
#..........................................             ...#
#........................................               @..#
#........................................             b ...#
#........................................               ...#
#...................       ~      !                     ...#
#...................          $      (     $    (       ...#
#............>...... !                        $         ...#
#...................  ~     $                         .....#
#...................      b           !           !   .....#
#...................                                  .....#
#...................          r          !    $         $  #
#....................................................      #
#....................................................      #
#....................................................      #
#..........................................................#
#..........................................................#
############################################################
