############################################################
#..........................................................#
#..........................................................#
#......................         ...........................#
#......             ...         ...........................#
#......             ...         ...........................#
#......             ...         ...........................#
#.....                  (                 .................#
#.....    !              ^              b .................#
#.....                              !     .................#
#.....                                    .................#
#.....        $            (    ^                   .......#
#.....      (                                       .......#
#.....                      ^ !~   $              ! .......#
#.....                        >        ~ b          .......#
#.....        !          (                          .......#
#.....            g         ~    !                  .......#
#...@.                                    .................#
#.....                        !           .................#
############################################################
