############################################################
#..........................................................#
#...................             $ (   @...................#
#...................                   ....................#
#................... ~                 ....................#
#...................  ~    (           ....................#
#...................        r          ..........>.........#
#...................             ~     ....................#
#.........                    $        ....................#
#.........    g   ^   ~                ....................#
#.........(              $    !        ....................#
#.........                     ............................#
#.........    r                ............................#
#..........................................................#
#..........................................................#
#..........................................................#
#..........................................................#
#..........................................................#
#..........................................................#
############################################################
