############################################################
#..............................>...........................#
#.......................................           ........#
#..................                (               ........#
#.................. ~                              ........#
#..................        b  $                    ........#
#..................                                ........#
#................                          b       ........#
#................         ^  ^                     ........#
#................                                  ........#
#................                    (                     #
#................                           b              #
#................     (                             $      #
#................                                 !        #
#................              b                           #
#...........@....                                          #
#..................                                        #
#..................                                 .......#
#..........................................................#
############################################################
