############################################################
#..........................................................#
#..........................................................#
#.................       ( ...    $         ...............#
#.................         ...         ^            .......#
#.................         ... r     g              .......#
#....>............         ...                      .......#
#.............................            (         .......#
#.............................                      .......#
#.............................                      .......#
#............................. (                    .......#
#............................. !            ...............#
#...@.........................     (        ...............#
#...................                                    ...#
#...................                                    ...#
#...................          (                         ...#
#...................                                    ...#
#...................                       ^            ...#
#...................       ~                          g ...#
############################################################
