############################################################
#..........................................................#
#..........................................................#
#..........................................................#
#..........................................................#
#............                                        ~.....#
#............                  @                      .....#
#............                          b              .....#
#............                               b       b .....#
#............                                         .....#
#............~                       r       ! !      .....#
#............                                         .....#
#............                         !               .....#
#............                        (                .....#
#............         (                               .....#
#............                                         .....#
#............      >                                  .....#
#..........................................................#
#..........................................................#
############################################################
